11111111111111111111111111111111111
11200000000000000000000000000000011
11000000003000000000000000001111111
11000011110000000000000000000000011
11000010000000003000000300000000011
11000010000000000000000000000000011
11000010000000000000000000000000011
11000000000001111000001111000000011
11000000000001000000000001000000011
11000000000001000000000001000000011
11000030000000000000000000000000011
11000000000001000000000001000000011
11000000000001000000000001000000011
11000003000000000000000000000000011
11000000000000000000000000000000011
11000000000000000030000000000000011
11000001111110000000000000001111111
11000000000000000000000000000000011
11111111111111111111111111111111111
